.....................................................................................................................................................................................
.....................................................................................................................................................................................
.....................................................................................................................................................................................
.....................................................................................................................................................................................
#####################################################################################################################################################################################
..................?#####?..................%........................................#................................................................................................
...................?##?....................%........................................#................................................................................................
....................?......................%..............................!.........#................................................................................................
@.........!......................=##################-....................=#-........#................................................................................................
..........#.......................$..?......#......#......................#........=#-...............................................................................................
..........#.............!.........$.........?......?......................#.........?................................................................................................
..........#.............#.........$.....!.......!.........................#..........................................................................................................
..........# ...........!#.........$!....!....!..#!........................#..........................................................................................................
#########################################################-.........=#################################################################################################################
........................................................#-.............?..#..?..#..?..#..?..#........................................................................................
........................................................#-................?.....?.....?.....?........................................................................................
........................................................#-...........................................................................................................................
........................................................#-................!.....!.....!.....!........................................................................................
........................................................#-.............!..#..!..#..!..#..!..#........................................................................................
........................................................#############################################################################################################################
.....................................................................................................................................................................................
.....................................................................................................................................................................................
.....................................................................................................................................................................................
.....................................................................................................................................................................................