........................................................................................................................................................................................
........................................................................................................................................................................................
........................................................................................................................................................................................
........................................................................................................................................................................................
########################################################################################################################################################################################
................???#####?..............?...%..........................................#....................#............................................................................
...................?##?....................%..........................................#...................=#-...........................................................................
....................?.............!........%................................!.........#..........!.........?............................................................................
@.........!......................=#####################-...................=#-........#.........=#-.....................................................................................
..........#.......................$..?.......#........#.....................#........=#-.........#......................................................................................
.........!#.............!.........$..........?........?.....................#.........?..........#.........!............................................................................
.........##.............#.........$.....!.........!.........................#....................#........=#-...........................................................................
......!!!## !!!........!#.........$!....#.....!...#!........................#....................#.........#............................................................................
#########################################################-.........=####################################################################################################################
........................................................#-.............#..?..#..?..#..?..#..?...........................................................................................
........................................................#-.............?.....?.....?.....?..............................................................................................
........................................................#-..............................................................................................................................
........................................................#-................!.....!.....!.....!...........................................................................................
........................................................#-.............!..#..!..#..!..#..!..#...........................................................................................
........................................................################################################################################################################################
........................................................................................................................................................................................
........................................................................................................................................................................................
........................................................................................................................................................................................
........................................................................................................................................................................................