................................................................................................................................................................................
................................................................................................................................................................................
................................................................................................................................................................................
................................................................................................................................................................................
################################################################################################################################################################################
.............?#####?..................%........................................#................................................................................................
..............?##?....................%........................................#................................................................................................
...............?......................%..............................!.........#................................................................................................
.@...!......................=##################-....................=#-........#................................................................................................
.....#.......................$..?......#......#......................#........=#-...............................................................................................
.....#.............!.........$.........?......?......................#.........?................................................................................................
.....#.............#.........$.....!.......!.........................#..........................................................................................................
.....# ...........!#.........$!....!....!..#!........................#..........................................................................................................
####################################################-.........=#################################################################################################################
...................................................#-.............?..#..?..#..?..#..?..#........................................................................................
...................................................#-................?.....?.....?.....?........................................................................................
...................................................#-...........................................................................................................................
...................................................#-................!.....!.....!.....!........................................................................................
...................................................#-.............!..#..!..#..!..#..!..#........................................................................................
...................................................#############################################################################################################################
................................................................................................................................................................................
................................................................................................................................................................................
................................................................................................................................................................................
................................................................................................................................................................................