#####################
#...................#
#...................#
#.........@.........#
#...................#
#...................#
#####################