##########################################################
#..................?.......?.......?.......?............=#
#.......................................................=#
#.......................................................=#
#.......................................................=#
#......................!.......!.......!................=#
#..@...............!...#...!...#...!...#...!............=#
############################################-...........=#
...........................................#.............#
...........................................#.............#
...........................................#-............#
...........................................#.............#
.............................###############-............#
................##############...........................#
................#........................................#
................#...*............###########-............#
................##################.........#.............#
...........................................#.............#
...........................................#.............#
...........................................#.............#
############################################-............#
#.......................................................=#
#.......................................................=#
#.......................................................=#
#........................................................#
#..................................................!!!...#
#.9...........................................!!!!!###!!!#
######......##############################################