##########################################################
#..................?.......?.......?.......?............=#
#.......................................................=#
#.......................................................=#
#.......................................................=#
#......................!.......!.......!................=#
#..@...............!...#...!...#...!...#...!............=#
############################################-...........=#
...........................................#.............#
...........................................#.............#
...........................................#-............#
...........................................#.............#
.............................###############-............#
................##############...........................#
................#........................................#
................#...*............###########-............#
................##################.........#.............#
...........................................#.............#
...........................................#.............#
...........................................#-............#
############################################.............#
#.......................................................=#
#.......................................................=#
#.......................................................=#
#........................................................#
#..................................................###...#
#.9...........................................!!!!!###!!!#
#######-...=##############################################
.....#-...=##
.....##-...=#
.....#-...=##
.....##-...=#
.....#-...=##
.....########