....................................##########################################################.....................
....................................#..................?.......?.......?.......?............=#.....................
....................................#.......................................................=#.....................
....................................#.......................................................=#.....................
....................................#.......................................................=#.....................
....................................#......................!.......!.......!................=#.....................
....................................#..@...............!...#...!...#...!...#...!............=#.....................
....................................############################################-...........=#.....................
...............................................................................#.............#.....................
...............................................................................#.............#.....................
...............................................................................#-............#.....................
...............................................................................#.............#.....................
.................................................................###############.............#.....................
............................######################################-..........................#.....................
............................#................................................................#.....................
............................#...........................*............###########-............#.....................
............................#....=####################################.........#.............#.....................
............................#.......#..........................................#.............#.....................
............................###-....#..........................................#.............#.....................
............................#.......#..........................................#-............#.....................
............................#....=##############################################.............#.....................
............................#.......#..............?..................?.....................=#.....................
............................###-....#-......................................................=#.....................
............................#.......#-......................................................=#.....................
............................#....=###-.......................................................#.....................
............................#.......#..................................................###...#.....................
............................#.........9...........................................!!!!!###!!!#.....................
............................##############-...=###############################################.....................
.........................................#-...=##............................................#.....................
.........................................##-...=#............................................#.....................
.........................................#-...=########################################################............
.........................................##-..........................................................w............
.........................................#-...........................................................w............
.........................................##############################################################.....................