....................................##########################################################
....................................#..................?.......?.......?.......?............=#
....................................#.......................................................=#
....................................#.......................................................=#
....................................#.......................................................=#
....................................#......................!.......!.......!................=#
....................................#..@...............!...#...!...#...!...#...!............=#
....................................############################################-...........=#
...............................................................................#.............#
...............................................................................#.............#
...............................................................................#-............#
...............................................................................#.............#
.................................................................###############-............#
............................######################################-..........................#
............................#................................................................#
............................#...........................*............###########-............#
............................#....=####################################.........#.............#
............................#.......#..........................................#.............#
............................###-....#..........................................#.............#
............................#.......#..........................................#-............#
............................#....=##############################################.............#
............................#.......#.......................................................=#
............................###-....#.......................................................=#
............................#.......#.......................................................=#
............................#....=###........................................................#
............................#.......#..................................................###...#
............................#.........9...........................................!!!!!###!!!#
............................##############-...=##############################################
.........................................#-...=##..................................................................
.........................................##-...=#..................................................................
.........................................#-...=##..................................................................
.........................................##-.......................................................................
.........................................#-........................................................................
.........................................########..................................................................